 ######
 #@ . #
##$$$ #
#.. * #
#######

